1111111111111111111111111111
1000000000000000000000000001
1011111111111111111111111001
10000000000000000000P1111001
1011111111111111111000001001
1010000000000000000111111001
1010111111111111111100001001
1010100000000000000011111001
101010111111111111111E001001
1010100000000000000010001001
1000111111111111111110001001
1010100000000000000000001001
1010101111111111111111111001
1010000000000000000000001001
1011111111111111111111111001
1C00000000000000000000000001
1111111111111111111111111111
