1111111111
100000P001
1E000001C1
1111111111