11111111111111111111111
100N0010000010PCE000001
10111110111110111111001
100000100000000N0010001
10111010111011111010001
10100000000010001010001
10101110111110111010001
10010001010N10001010001
10111110101110111110001
10000010000010000000001
10111110111111111111001
100N0010000010000000001
11111111111111111111111