111111111111111111111111111111111
1E00000C000000000000C111001100001
101111111111111100001111000000101
100000000000001111000000001111101
101111111111100001001111111000001
1010P0000000111101000000011111111
101011111110000101001110000001111
101010000011111101001110011101111
1000101111110000010100001110C0011
111111111111111111111111111111111