11111111
1000P001
1C0000E1
11111111