11111111111111111111111
10000010000010000000CE1
10111110111110111111001
10000010000000000010001
10111010111011111010001
10100010000010001010001
10101110111110111010001
10100010100010001010001
10111110101110111110001
10000010000010000000001
1011111C111111111111001
10000000000010000000001
10111110111110111111001
1P000000000010000000001
11111111111111111111111